++++++++++++++++++++++
+   +   ++ ++     +  F
+ +   +       +++ + ++
+ + +  ++  ++++   + ++
+++ ++++++    +++ + ++
+          ++  ++   ++
+++++ ++++++   +++++ +
+     +   +++++++  + +
+ +++++++  +   + +   +
+   +   ++ + + + + +++
+ +   +      +       +
+                    +
++++++++++++++++++S+++